3 3 0 5 6 0 3
0 0 0 4 4 2 1
2 1 1 4 3 2 1
2 1 1 4 3 2 2
2 1 1 4 3 2 4
2 1 1 4 3 2 0
